22222222222222200000011111111111111
22222222222222000000000111111111111
22222222222220000001000000001111111
22222222220000000011111100000222222
22222222222200001111110000000000222
22222222222000000001220000000000222
22222220000000000011222200000010002
22222200000000000111222220000110001
22220000000000000111222200011111001
22222000000000111122220000111111101
22222220000000001112210001111111111
22222222200000001222210000001111111
22222222000000011122111110000011111
22222000000001111222111000000000111
22222000000111111221110000111111111
22220000000001111111111000001111111
22000000000000011111111100000001111
11111110000000000011111111100000111
11111111100000000000001110000000011
11111111111110000000000000000000001
11111111111111111111110000000000011