11111111111111111111111111111111111111111111111
10000010000000000000000000000011000000000000011
10000010000010000000022000000011000000220000011
10001110000010000000022000000011000002222000011
10000010001110000000022000000011000000220000011
10010110000110000000022200000011000000020000011
10011110000010000000022200000011000000000000011
10000000000010000000222220000011000000000000011
11111111111111000000022200000011411111111111111
11111111111111000000002110000000000000000000011
10000000000000000000002110000000000000000000011
10000000000000000000000000000000000000000000011
10000000000000000000000000000000000000000000011
11111111110000000000000002222222222222222222222
10000000010000000000000002222222222222222222222
10000000110000000000000000000000000000000000011
10000000030000000000000002200000000000000000011
10000000010000000000000002200000000000000000011
10000000010000000000000002200000000000000000011
11111111110000000000000002200000000000000000011
11111111111111111111111112211111111111111111111
12345678901234567890123456789012345678901234567